NO ./assets/sprites/wall1.xpm
SO ./assets/sprites/wall2.xpm
WE ./assets/sprites/wall3.xpm
EA ./assets/sprites/wall4.xpm

F 255,146,146
C 138,242,221


111111111111111111111111
100000000000000000000001
100000000000000000000001
100000000000000000000001111111111111111111
100000111110000101010001000000100101010101
100000100010000000000001000000100101010101
100000100010000100010001000000000101010101
100000100010000000000010000001000101010111
100000110110000101010001000000000101010101
1000000000000000000000011111111111111111111
100000000000000000000001
100000000100000000000001              1 
1000000000000000000000011111111111111101
100000000N00000000000011111111111111101
10000000000000000000000111111        1
100000000000000000000001
111111111000000000000001
110100001000000000000001
110000101000000000000001
110100001000000000000001
110111111000000000000001
110000000000000000000001
111111111000000000000001
111111111111111111111111