NO ./assets/sprites/char_d.xpm
SO ./assets/sprites/char_d.xpm
WE ./assets/sprites/char_d.xpm
EA ./assets/sprites/char_d.xpm

F 250,100,0
C 225,30,0

        11111111
        1000000111011111111111
        1000000100000000000001
        10000000100000000000001
        1000000100000000000001
011111111111011100000000000001
100000000000000000000111111111
10000000000000000000000000000
10000000000000000000000000001
11110111110000000000000000001
10000000000000000S00000000001
10000000010000010000011111111  
10000000010000010000000000001110
10000000010000010000000000000001
11111111111111111111111111111111
