11111111
100EC001
1000N0P1
11111110